XXXXXXX
XXX XXX
XXX  XX
XX   XX
XX   PX
XXXXXXX