XXXXXXXXXXXXXXXXXXXX
XP            XXX  X
X XXXXX  X        FX
X  XXXX  XXXXX     X
X      XXX         X
XXX  XXXXXXXX   XXXX
X  F     XXXX      X
X      XXXX        X
X        F  XXX F  X
XXXXXXXXXXXXXXXXXXXX