XXXXXXXXXXXXXXXXXXXX
X             XXX  X
X   XXX  XX       FX
XXX XXXX  X XX X   X
X F   X PXXF  X X  X
XXX  XXXXXXXX X XXXX
X  F               X
X     XXXX         X
X        F XXXX    X
XXXXXXXXXXXXXXXXXXXX