XXXXXXXXXXXXXXXXXXXX
XXX  XXX      XXX  X
XX   X X   XX      X
X   XX F X  X XX XFX
X X   X FX  X X  XXX
XF X  XXX X X X XXFX
X XXF X            X
X  XX X XX    XXX  X
X  P      X X      X
XXXXXXXXXXXXXXXXXXXX