XXXXXXXXXXXXXXXXXXXX
XFXX  XXX      XXXFX
X   X X   XX       X
X X X   X  X XX X  X
XXX   X XXF  X X  XX
XF XXF XXXXXFX X XXX
X XXXXX            X
X     X XX         X
X  P      X X F    X
XXXXXXXXXXXXXXXXXXXX